[
  ["00", "01", "02", "02", "03", "03", "04"],
  ["00", "05", "05", "02", "03", "06", "06"],
  ["07", "07", "05", "08", "03", "03", "06"],
  ["09", "07", "07", "07", "03", "10", "10"],
  ["11", "11", "12", "12", "13", "13", "10"],
  ["14", "11", "14", "12", "13", "15", "15"],
  ["14", "14", "14", "16", "13", "13", "15"]
]