[
  ["00", "00", "00", "00", "00", "01", "01", "02", "02", "02", "03", "03", "03", "03", "04"],
  ["00", "05", "05", "06", "06", "06", "01", "02", "02", "03", "03", "07", "07", "04", "04"],
  ["08", "08", "05", "06", "06", "01", "01", "02", "09", "09", "09", "09", "07", "04", "04"],
  ["08", "05", "05", "06", "10", "01", "11", "11", "12", "13", "13", "07", "07", "14", "04"],
  ["08", "05", "15", "16", "10", "10", "17", "17", "12", "12", "13", "07", "14", "14", "18"],
  ["08", "15", "15", "16", "16", "10", "10", "17", "12", "13", "13", "19", "19", "14", "18"],
  ["15", "15", "20", "20", "16", "10", "17", "17", "12", "13", "21", "21", "19", "22", "18"],
  ["15", "23", "23", "20", "16", "16", "17", "24", "24", "24", "21", "19", "19", "22", "18"],
  ["23", "23", "20", "20", "25", "25", "24", "24", "26", "24", "21", "19", "22", "22", "18"],
  ["23", "23", "20", "25", "25", "25", "25", "26", "26", "26", "21", "21", "22", "22", "18"]
]